++++++++++++++++++++
++++++++++++++++++++
++++++       0    ++
+++++++++++++ + + ++
+++++++++++++ +++ ++
+++++++++++++A+++ ++
+++++++++++++a+++ ++
+++++++++++++ + + ++
+++++++++         ++
+++++++++++++ + + ++
+++++++++++++ +   ++
+++++++++++++     ++
++++++++++++++    ++
++++++++++++++++  ++
++++++++++++++++  ++
++++++++++        ++
+++++++++++ ++++  ++
++++++++++++++++  ++
++++++++++++++++++++
++++++++++++++++++++
