++++++++++++++++++++
++++++++++++++++++++
++++++++++++++++++++
++++++++++++++++++++
++++++++++++++++++++
++++++++++++++++ +++
+++++++          +++
++++++++++++++++  ++
+++ ++++++++++++  ++
+++ +++++++++++   ++
+++ ++++++++++++  ++
+++ +++ +++++++   ++
+++ +++    ++++   ++
+++ ++++++ ++++   ++
+++ ++++++ ++++   ++
+++        0A     ++
+++++++++++++ +   ++
+++++++++++++     ++
++++++++++++++++++++
++++++++++++++++++++
