++++++++++++++++++++
++++++++++++++++++++
+++++  ++++++++++  +
++++++  +++++++++  +
++++++  +++        +
++++++A   +        +
+++++++a           +
++++++++++    +    +
++++++++++++++++   +
++++++++++ +++++   +
++++++++++         +
+++++++++          +
++++++++++0        +
++++++++++++++++   +
+++++++++++++++++  +
+++++++++++++++++  +
+++++++++++++++++  +
+++++++++++++++++  +
++++++++++++++++++++
++++++++++++++++++++
