++++++++++++++++++++
++++++++++++++++++++
++++++++++++++  + ++
++++++++++++++  + ++
+++++++++++++++ + ++
+++++++++++++++   ++
++++++++        a ++
++++++++ ++ +++A+ ++
+++      ++ +++ + ++
+++ +++++++ +++   ++
+++++++++ + +++++ ++
+++++++++ + +++++ ++
+++++++++0+ +++++ ++
+++++++++ + +++++ ++
++++++    + +++++ ++
++++++ ++ +  ++++ ++
+++ ++ ++ +       ++
+++           ++++++
++++++++++++++++++++
++++++++++++++++++++
