++++++++++++++++++++
++++++++++++++++++++
+++++++++++++      +
+++++++++++++      +
+++++++++++++  ++  +
+++++++++++++  ++  +
+++++++++++++  ++  +
+++++++++++++ a++  +
+++++++++++++  ++  +
++++  +++++++  ++  +
++++   ++++++  ++  +
++++   +++ A   ++  +
++++   ++++    ++  +
++++   ++++    +   +
++++    +++  0     +
++++    ++++       +
++++    +++        +
+++++              +
++++++ +      ++++++
++++++++++++++++++++
