++++++++++++++++++++
++++++++++++++++++++
++++++++++++++++++++
++++++++++++++++++++
++++++++++++++++++++
++++++++++++ +++ +++
++++++++++++ +++ +++
++++++++++++ +++ +++
+++++  +++++ +++  ++
+++++ a+     +++  ++
++++   + +++++++  ++
++++++ +  A       ++
++++++    + + +++ ++
+++++ +   +++ + + ++
+++++ +   +     + ++
+++++ +  0    + + ++
+++++ +  ++ +     ++
+++++             ++
++++++++++++++++++++
++++++++++++++++++++
