++++++++++++++++++++
++++++++++++++++++++
+++++++++++++   + ++
+++++++++++++++   ++
+++++++++++++++ + ++
+++++++++++++++++ ++
+++++++++++++++++ ++
++++++++++++++++  ++
++++++++++++++++  ++
+++++++++++++++   ++
+++++++++ +++++ + ++
+++++++++   a     ++
+++++++++ ++++++  ++
+++++++ A ++++++  ++
++++++++++++++++  ++
++++++++++++++++  ++
+++++++++++++0    ++
++++++++++++++ +  ++
++++++++++++++++++++
++++++++++++++++++++
