++++++++++++++++++++
++++++++++++++++++++
+++++++     + ++ +++
++++ ++  ++ +    +++
++++           + +++
++++  +    ++     ++
++++  ++++ +++++  ++
++++  ++++ +++++  ++
++++ +++++0+++++  ++
++++ +++++ ++++++ ++
++++ +++++ ++++++ ++
++++ +++++ ++++++ ++
++++ ++++  ++++++ ++
++++ ++++  ++++++ ++
++++ ++++  ++++++ ++
++++       ++++++ ++
+++++++++A ++++   ++
++++++++++      + ++
++++++++++++++++++++
++++++++++++++++++++
