++++++++++++++++++++
++++++++++++++++++++
+++++++++++++++++ ++
+++++++++++++++++ ++
+++++   ++++++    ++
+++++++a++++++  + ++
+++++++ ++++++    ++
+++++++ ++        ++
+++++++    +++    ++
+++++++++++++++   ++
+++++++++++++++  +++
++++++++++++    + ++
+++++++++++++++ + ++
+++++++++++++++   ++
++++++++++++A +0+ ++
++++++++++++  + + ++
++++++++++++  + + ++
+++++++++++++   ++++
++++++++++++++++++++
++++++++++++++++++++
