++++++++++++++++++++
++++++++++++++++++++
++++++++++++ +++++++
+++ +++++ ++     +++
+++  ++++  ++     ++
+++ a++++  +++++  ++
+++  ++++   ++++  ++
+++  ++++    +++  ++
+++  ++++    ++++  +
+++  +++++    +++  +
+++  ++++++    ++  +
+++  ++++++     +  +
+++  ++++++A  0 +  +
+++  +++++      +  +
+++  +++           +
+++  +++           +
+++  +            ++
+++      +++++  ++++
++++   +++++++++++++
++++++++++++++++++++
