++++++++++++++++++++
++++++++++++++++++++
+++        ++++   ++
+++A0+++ + ++++   ++
+++ ++++ +++++    ++
+++ ++++ ++++   + ++
++++++++   ++++   ++
+++++++++      a+ ++
+++++++++++++++++ ++
+++++++++++++++++ ++
++++++++++++++++++++
+++++ ++++++++++++++
+++++ ++++++++++++++
+++++ ++++++++++++++
++    ++++++++++++++
+++ + ++++++++++++++
+++ + ++++++++++++++
+++ + ++++++++++++++
++++++++++++++++++++
++++++++++++++++++++
