++++++++++++++++++++
++++++++++++++++++++
++++++++++++++++++++
+++++++++ ++++ +++++
+++++++++ ++++ +++++
+++++++++ ++++ +++++
+++++++++ ++++ +++++
+++++++++ ++++ +++++
+++++++++ ++      ++
+++++++++ +  + ++ ++
+++++++++ +0   ++ ++
+++++++++    ++++ ++
+++++++++ +       ++
+++++++++     +++ ++
++++      +     + ++
++++++++   A ++ + ++
++++++++ +++a + + ++
++++++++          ++
++++++++++++++++++++
++++++++++++++++++++
