++++++++++++++++++++
++++++++++++++++++++
++++++   ++++++    +
++++++   ++++++    +
++++++   ++        +
++++     +++       +
+++++    +++   +   +
++++++   +         +
++++++   +     a   +
++++++   +         +
++++++  A+  0      +
++++++            ++
+++++++      ++   ++
++++++++     +++++++
++        ++++++++++
+++                +
+++++++++          +
++++++++++++++++++++
++++++++++++++++++++
++++++++++++++++++++
