++++++++++++++++++++
++++++++++++++++++++
+++++++++++++++++ ++
+++ +++++++++++++ ++
+++ +++++++++     ++
+++ +++++++++ ++++++
+++ +++++     ++++++
+++     ++++  ++++++
+++++++a++++  ++++++
+++++ + ++++  ++++++
+++++ +         ++++
+++++A   +++   +++++
++++++    ++   ++ ++
++++++            ++
++++++ + +   0    ++
++++++ + +      + ++
++++++      +   + ++
+++++++++++++++ + ++
++++++++++++++++++++
++++++++++++++++++++
