++++++++++++++++++++
++++++++++++++++++++
++ A+              +
++                 +
++   a     ++++    +
++  +      ++++    +
++  +  +   +++++   +
++  +  ++          +
++  ++++++         +
++  ++++++++++     +
++  +++++++++++    +
++  +++++++++++    +
++ 0+++++++++++   ++
++  +++++++++++++ ++
++  ++++++++++++++++
++  ++++++++++++++++
++ +++++++++++++++++
++++++++++++++++++++
++++++++++++++++++++
++++++++++++++++++++
