++++++++++++++++++++
++++++++++++++++++++
+++++++++++++++++ ++
++++++++++++++++  ++
+++++++++++++++++ ++
+++++++++++++++++ ++
+++++++++++++++++ ++
+++++++++++++++++ ++
+++++++++ +++++++ ++
+++++++++ +++++++ ++
+++++++++ +++++++ ++
+++++++++A++++    ++
+++++++++ ++ +    ++
+++++++++ ++ + ++ ++
+++++++++ ++ + ++ ++
+++++++++  +0+    ++
++++++++++ +   ++ ++
++++++++++        ++
++++++++++++++++++++
++++++++++++++++++++
