++++++++++++++++++++
++++++++++++++++++++
+++a ++   ++++++++++
++++  + +     ++++++
++++    +++++ +++ ++
+++++  ++++++A+   ++
++++   ++++++ +++ ++
++++ + ++++++ +++ ++
++++ + ++++++ +++ ++
++++      +++ ++++++
++++++ ++ +++ ++++++
++++++ ++ +++ ++++++
++++++ ++ + + ++++++
++++++  +  0+ ++++++
++++++  +++ + ++++++
+++++++ +        +++
+++++++ + + +     ++
+++++++   +       ++
++++++++++++++++++++
++++++++++++++++++++
