++++++++++++++++++++
++++++++++++++++++++
+++++++      ++   ++
+++++++ +         ++
+++++++ + + +++ + ++
+++++++  ++ +++ + ++
++++            + ++
++++ +++ ++ +   + ++
++++++ + ++ +   ++++
++++++A  ++    ++ ++
+++++++++++ ++ a  ++
+++++++++++ +     ++
+++++++++++ +     ++
+++++++++++ +   0 ++
+++++++++++++   ++++
+++++++++++++ + ++++
+++++++++++++++ ++++
++++++++++++++++++++
++++++++++++++++++++
++++++++++++++++++++
