++++++++++++++++++++
++++++++++++++++++++
+++++++++ ++++    ++
+++++++++ ++++ +++++
+++++++++ ++++ ++ ++
+++++++   ++++ ++ ++
+++++++ + +++++   ++
+++++++ +     + + ++
+++++++ + +++ + + ++
+++++++ +++++ + + ++
+++++++ +++++ + + ++
+++++++ ++++   a+ ++
+++++++ ++++ ++   ++
+++++++  + + ++++ ++
+++++++  +A+ ++++ ++
++++++ 0 +   ++++ ++
++++++++ +  ++    ++
++++++++       +++++
++++++++++++++++++++
++++++++++++++++++++
