++++++++++++++++++++
++++++++++++++++++++
++++++++++++++++  ++
++++++++++++++++  ++
+++++ A+++   +    ++
++++++ ++ ++      ++
++++++ ++ ++   +++++
++++++ ++ ++   +++++
++++++ ++ ++  0+++++
+++++      +  ++++++
++++ +      + ++++++
++++ + +  +   +++ ++
++++ + ++       + ++
++++ + ++ +++++   ++
++++ ++++ +++++++ ++
++++ ++++ ++++++++++
++++   ++ ++++++++++
++++++    ++++++++++
++++++++++++++++++++
++++++++++++++++++++
