++++++++++++++++++++
++++++++++++++++++++
++++++++++  ++  A ++
++++++++++  +  ++ ++
++++++ + ++ +     ++
++++++ + ++ + +++ ++
++++++a  ++   +++ ++
+++++     0       ++
+++++   +++  +++  ++
+++++   +++  ++++ ++
+++++  ++++++++++ ++
+++++ ++++++++    ++
+++++ +++++++++++ ++
+++++++++++++++++ ++
++++++++++++++++++++
++++++++++++++++++++
++++++++++++++++++++
++++++++++++++++++++
++++++++++++++++++++
++++++++++++++++++++
