++++++++++++++++++++
++++++++++++++++++++
++++++++          ++
++++++++ + ++ +++ ++
++++++++ + ++++++ ++
++++++++A  ++++ + ++
++++++     ++++ + ++
++++++++++a++++   ++
+++++++ +++++++   ++
+++++++ +++++++   ++
+++++++     +++   ++
+++++++++++    0++++
+++++++++++++++++ ++
+++++++++++++++++ ++
+++++++++++++++++ ++
+++++++++++++++++ ++
++++++++++++++++  ++
+++++++++++++++++ ++
++++++++++++++++++++
++++++++++++++++++++
