++++++++++++++++++++
++++++++++++++++++++
+++++++++++  ++++ ++
++++    ++++ ++++ ++
+++++++ ++++ ++++ ++
+++   0   ++ ++++ ++
+++++++    + +++  ++
+++++++++  +      ++
+++++++++  + ++++ ++
+++++++++         ++
++++++++++ +  +++ ++
++++++++++ ++ +++ ++
++++++++++      A ++
++++++++    + +++ ++
+++++++++   + +++ ++
++++++++++ ++ +++ ++
++++++++++a++ +++ ++
++++++++++ ++ +++ ++
++++++++++++++++++++
++++++++++++++++++++
