++++++++++++++++++++
++++++++++++++++++++
++++  A+++  ++++++++
++++ + +++      ++++
++++ + + +  +++ + ++
++++ + + +  +++ + ++
++++a+ + +  +++ + ++
+++++       +++ + ++
+++++  +++ ++++ + ++
+++++ ++++ ++++ + ++
++++++++++ ++++   ++
++++++++++ ++++++ ++
++++++++++ ++++++ ++
+++++++++++++++++ ++
++++++            ++
++++++++ +++  0+++++
+++++ ++ +++ + +++++
+++++        + +++++
++++++++++++++++++++
++++++++++++++++++++
