++++++++++++++++++++
++++++++++++++++++++
+++++++++   ++    ++
+++++++++ +       ++
++++++++  +  ++++ ++
++++++++  ++ ++++ ++
++++++++++++ ++++ ++
+++++++ ++ + ++   ++
+++++++ ++ +      ++
+++++++  0   +++  ++
+++++++ ++ a++++  ++
++++++++++  ++++  ++
+++     A   ++++ +++
+++++++++   ++++ +++
+++++++++   ++++ +++
+++++++++  +++++++++
++++++++++ +++++++++
++++++++++ +++++++++
++++++++++++++++++++
++++++++++++++++++++
