++++++++++++++++++++
++++++++++++++++++++
+++++++      + ++ ++
+++++++ ++++      ++
+++++++ ++++ ++++ ++
+++++++ ++++ ++++ ++
+++++++++++  ++   ++
+++0    +++ A++ + ++
+++++++ +++  ++ + ++
+++++++         a ++
+++++++++++++ ++  ++
+++++++++++++ ++  ++
++++++++++++     +++
++++++++++   +   +++
++++++  ++ +++++ +++
+++++++ ++ +++++ +++
+++++++ ++ +++++  ++
+++++++    +++++  ++
++++++++++++++++++++
++++++++++++++++++++
