++++++++++++++++++++
++++++++++++++++++++
+++++++++   A      +
+++++++++          +
+++++++++  ++++    +
+++++++++  ++++    +
+++++++++  ++++    +
+++++++++  ++++++  +
++++++++  +++++++  +
+++++++++ ++++++   +
++++++++++++++++   +
++++++++++++++++   +
++++++++++ a     +++
++++         0   +++
++++       ++  ++  +
++++  ++++++       +
+++++++++++++      +
+++++++++++++  +   +
+++++++++++++++++ ++
++++++++++++++++++++
