++++++++++++++++++++
++++++++++++++++++++
+++++++++      +++++
+++++++++0++++ +++++
+++++++++ ++++ +++++
+++++++++ ++++  ++++
++++++++++++++    ++
++++++++++++++ ++ ++
++++++++++++++ ++ ++
++++++++++++++ ++ ++
+++++++++++++aA   ++
+++++++++++++++++ ++
+++++++++++++++   ++
+++++++++++++++++ ++
++++++++++ ++++++ ++
++++++++++ ++++ + ++
++++++++++  +++ + ++
+++++++++++       ++
++++++++++++++++++++
++++++++++++++++++++
