++++++++++++++++++++
++++++++++++++++++++
++                ++
++a                +
+++++    ++++++++  +
+++++     +++++++  +
+++++      ++++++ ++
+++++      +++++++++
+++++      ++   ++++
+++++   +A +++   +++
+++++   +  ++ 0  +++
+++++  ++  +++    ++
+++++++++  ++++    +
+++++++++  ++++    +
+++++++++  +       +
+++++++++  +       +
+++++++++  +  +    +
+++++++++    ++    +
++++++++++   ++++ ++
++++++++++++++++++++
