++++++++++++++++++++
++++++++++++++++++++
++++++++++    ++++++
++++++++++  0  +++++
++++++++++  +  +++++
+++++++++   + ++++++
+++++++++      +++++
+++++++++      +++++
+++++++++     ++++++
++++++++++    +++ ++
+++++++     +     ++
+++++    ++ +++++ ++
+++++    ++ +++++ ++
++++++   ++++++++ ++
+++++++   A++++ + ++
+++++++  + ++++ + ++
+++++++  + ++++ + ++
+++++++  +      + ++
++++++++++++++++++++
++++++++++++++++++++
