++++++++++++++++++++
++++++++++++++++++++
++++++++++++   +++++
++++++++++++ + +++++
++++++++++++ + +++++
++++++++++++A+  ++++
++++++++ +++ ++ + ++
++ +++++ ++  ++ + ++
++ +++++ a   ++ + ++
++ ++++++    ++   ++
++ +++++ ++  ++++ ++
++    ++ ++       ++
++ ++ ++ ++    ++ ++
+++++ ++ ++  + +++++
+++++    ++    +++++
+++++  +     + +++++
+++++ ++ +++0+ +++++
+++++        + +++++
++++++++++++++++++++
++++++++++++++++++++
