++++++++++++++++++++
++++++++++++++++++++
++++++         ++  +
++++++        +++  +
++++++  ++    +++  +
++++    ++   +     +
++++        ++     +
++++        ++  +  +
++++a+  ++  ++  +  +
++++++  +++   A    +
++++++  ++++0     ++
+++++  ++++++   ++++
+++++  +++++++++++++
+++++  +++++++++++++
+++++  +++++++++++++
+++   ++++  ++++++++
+++  +++++  ++++++++
+++        +++++++++
++++       +++++++++
++++++++++++++++++++
