++++++++++++++++++++
++++++++++++++++++++
+++++ ++++++++++++++
+++++ ++++++++++++++
+++++    ++ ++++++++
++++++++ ++ ++++++++
++++++++    ++    ++
++++++++++  A     ++
++++++    +    ++ ++
+++++++++  a ++++ ++
+++++++++    ++++ ++
+++++++++ 0  ++++ ++
++++++++++   ++++ ++
+++++++++++ +  +  ++
+++++++++++ +     ++
+++++++++++ ++ +  ++
+++++++++++       ++
++++++++++++++    ++
++++++++++++++++++++
++++++++++++++++++++
