++++++++++++++++++++
++++++++++++++++++++
++++++++++++      ++
++++++++++++ ++   ++
+++++++    + ++   ++
++++++++          ++
++++++++++ + ++ + ++
+++++++++ 0+ ++ + ++
++++++++++++  +   ++
++++++++++++A   + ++
+++++++++++++     ++
+++++++++++++ +++ ++
+++++++++++++ +++ ++
+++++++++++++ +++ ++
+++++++++++++     ++
+++++++++++++++++ ++
+++++++++++++++++ ++
+++++++++++++++++ ++
++++++++++++++++++++
++++++++++++++++++++
