++++++++++++++++++++
++++++++++++++++++++
++++++++++++++++++++
++++++++++++++++++++
++++++++++++++++++++
++++++++++++++++++++
++++++++++++++++++++
+++++++++++++++++ ++
+++++++++++++++++ ++
++++++++++++ +++  ++
+++++++++ ++ + +  ++
++++++++     + +  ++
+++++++++ ++      ++
+++++++++ +  +    ++
++++++++     +++  ++
++++++++  ++  a0  ++
++++++++A ++  + + ++
++++++++          ++
++++++++++++++++++++
++++++++++++++++++++
